5 5 5 5 5 5 5 5 5 5 5 5 5 5 5 	 
5 5 5 5 5 5 5 5 5 5 5 5 5 5 5 	 
4 4 4 4 4 3 3 0 3 3 4 4 4 4 4 	 
4 1 4 1 4 3 3 1 3 3 4 1 4 1 4 	 
3 3 3 3 3 3 3 3 3 3 3 3 3 3 3 	 
3 3 1 3 3 3 3 3 3 3 3 3 1 3 3 	 
2 2 2 2 2 2 2 2 2 2 2 2 2 2 2 	 
2 2 2 2 2 2 2 0 2 2 2 2 2 2 2 	